smell me! I am poop!
⠀⠀⠀⠀⠀⠀⠀⠀⠀⠀⠀⠀⠀⠀⠀⠀⠀⠀⠀⠀⠀⢰⣤⡀⠀⠀⠀⠀⠀⠀
⠀⠀⠀⠀⠀⠀⠀⠀⠀⠀⠀⠀⠀⠀⠀⠀⠀⠀⠀⠀⠀⢸⣿⣿⣤⣤⣄⠀⠀⠀
⠀⠀⠀⠀⠀⠀⠀⠀⠀⠀⠀⠀⠀⠀⠀⠀⠀⠀⠀⠀⢀⣾⣿⣿⣿⣿⣿⣷⣶⣶
⠀⠀⠀⠀⠀⠀⠀⠀⠀⠀⠀⣀⣤⣴⣶⣶⣶⣶⣾⣿⣿⣿⣿⣿⣿⣿⣿⣿⣿⠟
⠀⠀⠀⠀⣀⠀⠀⠀⣠⣶⣿⣿⣿⣿⣿⣿⣿⣿⣿⣿⣿⣿⣿⣿⡿⠛⠛⠛⠁⠀
⠀⠀⠀⢰⣿⣷⣦⣼⣿⣿⣿⣿⣿⣿⣿⣿⣿⣿⣿⣿⣿⣿⣿⡟⠁⠀⠀⠀⠀⠀
⠀⠀⠀⠀⠉⠻⣿⣿⣿⣿⣿⣿⣿⣿⣿⣿⣿⣿⣿⣿⣿⣿⠏⠀⠀⠀⠀⠀⠀⠀
⠀⠀⠀⠀⠀⠀⢸⣿⣿⣿⣿⣿⣿⣿⣿⣿⣿⣿⣿⣿⣿⠋⠀⠀⠀⠀⠀⠀⠀⠀
⠀⠀⠀⠀⠀⠀⢸⣿⣿⣿⣿⣿⣿⣿⣿⣿⣿⣿⣿⣿⠁⠀⠀⠀⠀⠀⠀⠀⠀⠀
⠀⠀⠀⠀⠀⠀⠈⠻⣿⣿⣿⣿⣿⡇⠀⠀⢿⣿⣿⣿⠀⠀⠀⠀⠀⠀⠀⠀⠀⠀
⠀⠀⢀⡄⠀⠀⠀⠀⠈⠻⣿⣿⣿⠇⠀⠀⢸⣿⣿⣿⠀⠀⠀⠀⠀⠀⠀⠀⠀⠀
⠀⣀⢼⣿⣦⡄⠀⠀⠀⢰⣿⣿⠏⠀⠀⠀⠈⣿⣿⣿⠀⠀⠀⠀⠀⠀⠀⠀⠀⠀
⠼⠿⠿⠿⠿⠿⠆⠀⠀⠿⠿⠏⠀⠀⠀⠀⠀⠹⠿⠿⠀⠀⠀⠀⠀⠀⠀⠀⠀⠀
